Da rules 2

   #####
####   ####
#.$  @  $.#
####   ####
   #####