Rooms

  ######
###    #
#    $ #
# ###$##
#  @ ..#
########